9 2
011000000
021100000
221220000
222100000
211100000
000000000
000000000
000000000
000000000