9 1
000000000
000010000
000012200
000221120
000012110
000012200
000000000
000000000
000000000