100 2
0001000001100000011100100000110000001110010000011000000111001000001100000011100100000110000001112222
0000000000000000001111000000000000000002222222222222111111111110000000000000000000000000000000000000
0000000000000000000000000000001111111111111111111000000000000000000000000000000000000000000000000000
0001000001100000011100100000110000001110010000011000000111001000001100000011100100000110000001112222
0000000000000000001111000000000000000002222222222222111111111110000000000000000000000000000000000000
0000000000000000000000000000001111111111111111111000000000000000000000000000000000000000000000000000
0000000000000000000000000000000000000000000000000000000000000000000000000000000000000000000000000000
0000000000000000000000000000000000000000000000000000000000000000000000000000000000000000000000000000
0001000001100000011100100000110000001110010000011000000111001000001100000011100100000110000001112222
0000000000000000001111000000000000000002222222222222111111111110000000000000000000000000000000000000
0000000000000000000000000000001111111111111111111000000000000000000000000000000000000000000000000000
0001000001100000011100100000110000001110010000011000000111001000001100000011100100000110000001112222
0000000000000000001111000000000000000002222222222222111111111110000000000000000000000000000000000000
0000000000000000000000000000001111111111111111111000000000000000000000000000000000000000000000000000
0000000000000000000000000000000000000000000000000000000000000000000000000000000000000000000000000000
0000000000000000000000000000000000000000000000000000000000000000000000000000000000000000000000000000
0001000001100000011100100000110000001110010000011000000111001000001100000011100100000110000001112222
0000000000000000001111000000000000000002222222222222111111111110000000000000000000000000000000000000
0000000000000000000000000000001111111111111111111000000000000000000000000000000000000000000000000000
0001000001100000011100100000110000001110010000011000000111001000001100000011100100000110000001112222
0000000000000000001111000000000000000002222222222222111111111110000000000000000000000000000000000000
0000000000000000000000000000001111111111111111111000000000000000000000000000000000000000000000000000
0000000000000000000000000000000000000000000000000000000000000000000000000000000000000000000000000000
0000000000000000000000000000000000000000000000000000000000000000000000000000000000000000000000000000
0001000001100000011100100000110000001110010000011000000111001000001100000011100100000110000001112222
0000000000000000001111000000000000000002222222222222111111111110000000000000000000000000000000000000
0000000000000000000000000000001111111111111111111000000000000000000000000000000000000000000000000000
0001000001100000011100100000110000001110010000011000000111001000001100000011100100000110000001112222
0000000000000000001111000000000000000002222222222222111111111110000000000000000000000000000000000000
0000000000000000000000000000001111111111111111111000000000000000000000000000000000000000000000000000
0000000000000000000000000000000000000000000000000000000000000000000000000000000000000000000000000000
0000000000000000000000000000000000000000000000000000000000000000000000000000000000000000000000000000
0001000001100000011100100000110000001110010000011000000111001000001100000011100100000110000001112222
0000000000000000001111000000000000000002222222222222111111111110000000000000000000000000000000000000
0000000000000000000000000000001111111111111111111000000000000000000000000000000000000000000000000000
0001000001100000011100100000110000001110010000011000000111001000001100000011100100000110000001112222
0000000000000000001111000000000000000002222222222222111111111110000000000000000000000000000000000000
0000000000000000000000000000001111111111111111111000000000000000000000000000000000000000000000000000
0000000000000000000000000000000000000000000000000000000000000000000000000000000000000000000000000000
0000000000000000000000000000000000000000000000000000000000000000000000000000000000000000000000000000
0000000000000000001111000000000000000002222222222222111111111110000000000000000000000000000000000000
0000000000000000000000000000001111111111111111111000000000000000000000000000000000000000000000000000
0001000001100000011100100000110000001110010000011000000111001000001100000011100100000110000001112222
0000000000000000001111000000000000000002222222222222111111111110000000000000000000000000000000000000
0000000000000000000000000000001111111111111111111000000000000000000000000000000000000000000000000000
0000000000000000000000000000000000000000000000000000000000000000000000000000000000000000000000000000
0000000000000000000000000000000000000000000000000000000000000000000000000000000000000000000000000000
0001000001100000011100100000110000001110010000011000000111001000001100000011100100000110000001112222
0000000000000000001111000000000000000002222222222222111111111110000000000000000000000000000000000000
0000000000000000000000000000001111111111111111111000000000000000000000000000000000000000000000000000
0001000001100000011100100000110000001110010000011000000111001000001100000011100100000110000001112222
0000000000000000001111000000000000000002222222222222111111111110000000000000000000000000000000000000
0000000000000000000000000000001111111111111111111000000000000000000000000000000000000000000000000000
0001000001100000011100100000110000001110010000011000000111001000001100000011100100000110000001112222
0000000000000000001111000000000000000002222222222222111111111110000000000000000000000000000000000000
0000000000000000000000000000001111111111111111111000000000000000000000000000000000000000000000000000
0001000001100000011100100000110000001110010000011000000111001000001100000011100100000110000001112222
0000000000000000001111000000000000000002222222222222111111111110000000000000000000000000000000000000
0000000000000000000000000000001111111111111111111000000000000000000000000000000000000000000000000000
0000000000000000000000000000000000000000000000000000000000000000000000000000000000000000000000000000
0000000000000000000000000000000000000000000000000000000000000000000000000000000000000000000000000000
0000000000000000001111000000000000000002222222222222111111111110000000000000000000000000000000000000
0000000000000000000000000000001111111111111111111000000000000000000000000000000000000000000000000000
0001000001100000011100100000110000001110010000011000000111001000001100000011100100000110000001112222
0000000000000000001111000000000000000002222222222222111111111110000000000000000000000000000000000000
0000000000000000000000000000001111111111111111111000000000000000000000000000000000000000000000000000
0000000000000000000000000000000000000000000000000000000000000000000000000000000000000000000000000000
0000000000000000000000000000000000000000000000000000000000000000000000000000000000000000000000000000
0001000001100000011100100000110000001110010000011000000111001000001100000011100100000110000001112222
0000000000000000001111000000000000000002222222222222111111111110000000000000000000000000000000000000
0000000000000000000000000000001111111111111111111000000000000000000000000000000000000000000000000000
0001000001100000011100100000110000001110010000011000000111001000001100000011100100000110000001112222
0000000000000000001111000000000000000002222222222222111111111110000000000000000000000000000000000000
0000000000000000000000000000001111111111111111111000000000000000000000000000000000000000000000000000
0001000001100000011100100000110000001110010000011000000111001000001100000011100100000110000001112222
0000000000000000001111000000000000000002222222222222111111111110000000000000000000000000000000000000
0000000000000000000000000000001111111111111111111000000000000000000000000000000000000000000000000000
0001000001100000011100100000110000001110010000011000000111001000001100000011100100000110000001112222
0000000000000000001111000000000000000002222222222222111111111110000000000000000000000000000000000000
0000000000000000000000000000001111111111111111111000000000000000000000000000000000000000000000000000
0000000000000000000000000000000000000000000000000000000000000000000000000000000000000000000000000000
0000000000000000000000000000000000000000000000000000000000000000000000000000000000000000000000000000
0000000000000000001111000000000000000002222222222222111111111110000000000000000000000000000000000000
0000000000000000000000000000001111111111111111111000000000000000000000000000000000000000000000000000
0001000001100000011100100000110000001110010000011000000111001000001100000011100100000110000001112222
0000000000000000001111000000000000000002222222222222111111111110000000000000000000000000000000000000
0000000000000000000000000000001111111111111111111000000000000000000000000000000000000000000000000000
0000000000000000000000000000000000000000000000000000000000000000000000000000000000000000000000000000
0000000000000000000000000000000000000000000000000000000000000000000000000000000000000000000000000000
0001000001100000011100100000110000001110010000011000000111001000001100000011100100000110000001112222
0000000000000000001111000000000000000002222222222222111111111110000000000000000000000000000000000000
0000000000000000000000000000001111111111111111111000000000000000000000000000000000000000000000000000
0001000001100000011100100000110000001110010000011000000111001000001100000011100100000110000001112222
0000000000000000001111000000000000000002222222222222111111111110000000000000000000000000000000000000
0000000000000000000000000000001111111111111111111000000000000000000000000000000000000000000000000000
0001000001100000011100100000110000001110010000011000000111001000001100000011100100000110000001112222
0000000000000000001111000000000000000002222222222222111111111110000000000000000000000000000000000000
0000000000000000000000000000001111111111111111111000000000000000000000000000000000000000000000000000
0001000001100000011100100000110000001110010000011000000111001000001100000011100100000110000001112222
0000000000000000001111000000000000000002222222222222111111111110000000000000000000000000000000000000