6 1
111111
122221
122021
122221
111111
111111